"┌-─-─-┐                  ",
"+¢¢¢¢¢+                  ",
"└-┐¢┌─┘                  ",
"  │¢└┐                   ",
"  │¢¢│                   ",
"┌─└─¢│                   ",
"│¢¢¢¢│                   ",
"│¢┌──┘                   ",
"│ÕC%│                    ",
"│¤%%│                    ",
"└───┘                    ",