"┌─-┐ ┌─┐                 ",
"+..└-┘.└┐                ",
"│.Îf%.Î.+                ",
"+..%%...└┐               ",
"└┐...Î/Î.└┐              ",
" └┐Î.....┌┘              ",
" ┌┘..A%Î.└┐              ",
"┌┘...%%.Î┌┘              ",
"└─-─-┐Î▄┌┘               ",
"     └┐┌┘                ",
"      └┘                 ",
