"┌─-┐                     ",
"+..└──-─┐                ",
"│~.v%...+                ",
"+.~%%~.~└┐               ",
"└┐.......└┐              ",
" └┐.~~.~¥┌┘              ",
" ┌┘.¤...┌┘               ",
" +.~.~.~└┐               ",
" └┐......+               ",
"  └┐.~‡~┌┘               ",
"   └-┐.┌┘                ",
"     └-┘                 ",
