"  ┌──┐                   ",
" ┌┘‡$└┐                  ",
"┌┘....└┐                 ",
"│.±K%±.│                 ",
"│..%%..│                 ",
"│.±..±.│                 ",
"+......+                 ",
"│.±..±.│                 ",
"+......+                 ",
"└─----─┘                 ",