"┌────────┐               ",
"│h%.■■⌐h%│               ",
"│%%....%%│               ",
"└┐.┌§§┐.┌┘               ",
" │.│¤¤│.│                ",
" │.│▄$│.│                ",
"┌┘.└──┘.└┐               ",
"+........+               ",
"└───-─-──┘               ",