" ┌-───────┐             ",
"┌┘.≈≈≈≈≈..└┐            ",
"+..¤≈≈≈≈≈..+            ",
"│..≈≈≈≈≈¥..│            ",
"+....D%....+            ",
"│..δ.%%....│            ",
"+..≈≈≈≈≈¥..+            ",
"└┐..≈≈≈≈≈.┌┘            ",
" └-───────┘             ",