"┌──┐    ┌─┐              ",
"+..└────┘ø│              ",
"│ø...▄....└┐             ",
"+..........+             ",
"└┐.....ø..┌┘             ",
" └──┐....┌┘              ",
"    │.w%┌┘               ",
"    └┐%%│                ",
"     └──┘                ",