"   ┌-─┐                  ",
"   │..└─┐ ┌──┐           ",
" ┌─┘...ø+ │R%│           ",
"┌┘¤.....└─┘%%+           ",
"│.r%.....ø...│           ",
"+.%%...r%.„┌-┘           ",
"│......%%.┌┘             ",
"└┐ø...¤┌─-┘              ",
" └┐...┌┘                 ",
"  └─-─┘                  ",
