"┌────────-┐              ",
"│.........│              ",
"│.┌─────┐.│              ",
"│.│.....│.+              ",
"│.│.┌─┐.│.│              ",
"│Õ│Õ│▄│Õ│.│              ",
"│.│...│.│.+              ",
"│.└───┘.│.│              ",
"│.......│.│              ",
"└───────┘-┘              ",