"     ┌──┐                 ",
"    ┌┘p%└┐                ",
"   ┌┘.%%.└┐               ",
"  ┌┘......└┐              ",
" ┌┘¥..▄▄..¥└┐             ",
"┌┘....œœ....└┐            ",
"+............+            ",
"└──-──-──-───┘            ",