" ┌-──┐┌───┐              ",
"┌┘...└┘!!Ý└┐             ",
"│...W%.....│             ",
"+...%%.....+             ",
"│...ÜøÜW%..│             ",
"└┐.....%%.┌┘             ",
" └┐......┌┘              ",
" ┌┘......└┐              ",
" +........+              ",
" └┐■.^..■┌┘              ",
"  └─-──-─┘               ",