"  ┌-┐  ┌-┐               ",
" ┌┘.└┐┌┘.└┐              ",
"┌┘i%.└┘.i%└┐             ",
"+.%%....%%.+             ",
"└┐..!┌┐}..┌┘             ",
" └┐.┌┘└┐.┌┘              ",
" ┌┘.└┐ └-┘               ",
"┌┘.i%└┐                  ",
"+..%%.+                  ",
"└┐!..┌┘                  ",
" └┐.┌┘                   ",
"  └-┘                    ",