"   ┌-┐                   ",
"  ┌┘Ô└┐                  ",
"  +...│                  ",
" ┌┘...└┐                 ",
"┌┘$.s%.└┐                ",
"+Ô..%%.Ô+                ",
"└┐ø...⌠┌┘                ",
" └┐...┌┘                 ",
"  │...+                  ",
"  └┐Ô┌┘                  ",
"   └-┘                   ",