"┌──┐┌─-─┐┌─┐             ",
"│Ý?││Ý Ý││Ý│             ",
"│..└┘...└┘.│             ",
"│N%...u%...+             ",
"│%%┌┐.%%┌┐.│             ",
"│ÝÝ││Ý.Ý││Ý│             ",
"└──┘└─-─┘└─┘             ",